1111111111
1000000001
1000000001
1000000001
1000000001
1000000001
1000000001
1000000001
1000000001
1001001001
1001001001
10010$1001
1001111001
1000000001
1111111111
