1111111111
1000000011
1111110001
1110011001
1110$11001
1110011001
1110011001
1111011001
1011000001
1000000001
1000000001
1000000001
1000000001
1000000001
1111111111
