1111111111
1000000111
1100110001
1100111101
1000000001
1001111001
1011111101
1001111001
1101110011
1101110111
1001110001
1011$11101
1001011001
1100000011
1111111111
