1111111111
1000100001
1011101101
1000001001
1011111011
1000011001
1101000101
1001111001
1101010101
1100010101
1101010001
1000011011
1111111011
1$00000011
1111111111
