1111111111
1000000001
1011010001
1010000001
1010$10001
1010010001
1011110001
1000000001
1000000001
1000000001
1000000001
1000000001
1000000001
1000000001
1111111111
