111111111111111
100000000000001
100111111011111
100111111010$01
1000#0011010001
10#000011010001
111110011010001
111110011010001
110#00011010001
110000011010001
11011##11000011
110110011111011
100000#000#1011
11111000#000011
111111111111111
